   ############################
   #        #        #        #
#  #  #######  #  ##########  #
#  S           #     #        #
#  ####  ####  #  ####  ####  #
#  #        #  #           #  #
###################  ##########
#  #                          #
#  #  #######  #  #  #  ####  #
#     #  #     #  #  #  #     #
#  ####  ####  #######  ####  #
#  #        #     #     #     #
#  ####  ####  ####  ####  #  #
#           #  #        #  #  #
#  ##########  #  #  #######  #
#        #  #  #  #        #  #
##########  ########## E ######
#                          #  #
####  ####  #  #######  #  #  #
#        #  #        #  #  
############################  
