#########
#   #   #
# ### # #
#    S# #
### ### #
#     # #
# ##### #
#       #
#####E###
