##########
#  #   S#
# #######
#     # #
### ### #
#     # #
# ##### #
#       #
#####E###
